11
8
37 56 55 53 55 56 54 52 54 53 37 
37 0 0 0 0 0 0 0 0 0 37 
37 0 0 0 0 0 0 0 0 0 37 
37 0 0 0 0 0 0 0 0 0 37 
37 0 0 0 0 0 0 0 0 0 37 
37 0 0 0 0 0 0 0 0 0 37 
36 0 15 0 0 0 0 0 15 0 36 
52 52 52 52 52 52 52 52 52 52 52 
