147
8
34 34 33 34 33 34 34 4 0 0 0 0 0 0 0 0 0 0 0 0 0 0 0 0 0 0 0 0 0 0 0 6 0 0 0 0 0 0 0 0 0 0 0 0 0 0 0 0 0 0 0 0 0 0 0 0 0 0 0 0 0 0 0 0 0 0 0 0 0 0 0 0 0 0 0 0 0 0 0 0 0 0 36 0 0 0 0 0 0 0 0 0 0 0 0 0 0 0 0 0 0 0 0 0 0 0 0 0 0 0 0 35 0 0 0 36 0 0 0 0 0 0 0 0 0 0 0 0 0 0 0 0 0 0 0 0 0 0 0 0 0 0 0 0 37 37 37 
32 0 35 0 35 0 0 0 0 0 0 0 0 0 0 0 0 0 0 0 0 0 0 0 0 0 0 0 0 0 0 0 0 0 0 0 0 0 0 0 0 0 0 0 0 0 0 0 0 0 0 0 0 0 0 0 0 0 0 0 0 0 0 0 0 0 0 0 0 0 0 0 0 0 0 0 0 0 0 0 0 0 33 0 0 0 0 0 0 0 0 0 0 0 0 0 0 0 0 0 0 0 0 0 0 0 0 0 0 0 0 0 0 0 3 33 40 39 34 4 0 0 0 0 0 0 0 0 0 0 0 0 3 33 33 34 33 33 4 0 0 0 0 0 37 37 37 
41 32 35 0 35 0 0 0 0 0 0 0 0 0 0 0 0 0 8 0 0 0 0 0 0 5 0 0 30 31 31 32 0 0 7 0 0 0 0 0 0 0 0 0 0 0 0 0 0 0 0 0 0 0 0 0 0 0 0 0 0 0 0 0 0 0 3 33 4 0 0 0 0 0 0 0 0 0 0 0 0 0 35 0 0 0 0 0 0 0 0 0 0 0 0 0 0 0 0 0 0 0 0 0 0 0 0 0 0 0 0 0 0 0 0 35 0 0 0 0 3 33 34 34 34 34 34 33 34 34 33 4 0 35 35 0 35 35 0 0 0 0 0 0 37 37 37 
41 41 32 0 35 0 38 0 0 9 0 0 0 2 0 0 0 0 0 0 0 0 0 0 0 0 0 0 41 41 41 41 38 0 0 0 0 0 0 0 0 0 0 0 0 0 0 0 0 0 0 0 0 0 0 0 0 0 0 0 0 0 3 33 4 0 0 35 0 0 0 0 0 0 0 0 0 0 0 0 0 0 0 0 0 0 0 0 0 0 0 0 0 0 0 0 0 0 0 0 0 0 0 0 0 0 35 0 0 0 0 0 0 0 0 0 0 0 0 0 0 35 0 0 0 0 0 35 0 0 35 0 0 35 35 0 35 35 0 30 32 0 0 0 37 37 37 
41 41 41 32 35 0 37 0 0 0 0 0 0 0 0 0 0 0 0 0 0 0 0 0 0 0 0 0 41 41 41 41 36 0 0 0 0 0 0 0 0 0 0 0 0 0 0 0 0 0 0 0 0 0 0 0 0 0 0 0 0 0 0 35 0 0 0 35 0 0 3 33 34 33 4 0 0 0 38 0 0 0 0 0 0 0 0 0 0 0 0 0 0 0 0 0 0 0 0 0 0 0 0 0 0 0 35 0 0 0 0 35 0 0 0 0 0 0 0 0 38 35 0 0 0 0 0 30 31 31 31 31 31 31 31 31 31 32 0 0 0 0 0 0 36 37 37 
41 41 41 41 32 0 37 0 0 0 0 0 0 0 0 0 30 32 34 33 34 33 34 33 34 33 34 33 41 41 41 41 31 31 31 32 0 0 0 0 0 0 0 0 0 0 0 0 0 0 0 30 31 32 33 39 33 34 33 4 0 0 0 35 0 0 0 35 0 0 0 35 0 35 0 0 0 0 37 0 0 0 0 0 0 0 0 0 3 33 34 33 34 33 4 0 0 0 0 0 0 0 38 0 0 3 33 4 0 0 0 35 0 0 0 0 3 33 34 4 37 30 31 31 32 0 0 0 0 0 0 0 0 0 0 0 0 0 0 0 0 0 30 31 32 36 37 
41 41 41 41 41 32 36 0 0 0 0 0 0 0 0 30 41 37 0 35 0 35 0 35 0 35 0 35 41 41 41 41 41 41 41 41 31 31 31 31 31 31 31 31 31 31 31 31 31 31 31 41 41 41 35 0 35 0 35 0 0 0 0 35 0 0 0 35 0 0 0 35 0 35 0 0 0 3 33 4 0 0 38 0 0 0 0 0 0 35 0 35 0 30 31 31 31 31 31 31 31 32 36 0 0 0 35 0 0 0 3 33 4 0 0 0 0 35 0 0 36 41 41 41 41 0 0 0 0 0 0 0 0 0 0 0 0 0 0 0 0 0 0 0 30 32 36 
34 34 33 34 33 39 33 34 33 34 33 34 33 39 31 41 41 37 0 35 0 35 0 35 0 35 0 35 41 41 41 41 41 41 41 41 41 41 41 41 41 41 41 41 41 41 41 41 41 41 41 41 41 41 40 4 35 0 35 0 0 0 0 35 0 0 0 35 0 0 0 35 0 35 0 0 0 0 35 0 0 0 33 0 0 0 0 0 0 35 0 30 31 41 41 41 41 41 41 41 41 41 31 31 31 32 35 0 0 0 0 35 0 0 0 0 0 30 31 31 31 41 41 41 41 31 31 31 31 31 31 31 31 31 31 31 32 0 0 30 32 0 0 0 0 30 31 
