100
37
46 46 46 46 46 46 46 46 46 46 46 46 46 46 46 46 46 46 46 46 46 46 46 46 46 46 46 46 46 46 46 46 46 46 46 46 46 46 46 46 46 46 46 46 46 46 46 46 46 46 46 46 46 46 46 46 46 46 46 46 46 46 46 46 46 51 46 46 46 46 46 46 46 46 46 46 46 46 46 46 46 46 46 46 51 46 46 46 46 46 51 46 46 46 46 46 46 46 46 46 
46 0 0 0 0 0 0 0 0 0 0 0 16 16 16 16 16 16 16 16 16 16 16 16 16 16 16 16 16 16 16 16 16 16 16 16 16 16 16 16 16 16 16 16 16 16 16 16 16 16 16 16 16 16 16 16 16 16 16 16 16 16 16 16 16 16 16 16 16 46 44 44 44 44 44 44 44 44 44 44 44 44 44 46 0 0 0 0 0 0 0 0 0 0 0 0 0 0 0 51 
46 0 0 0 0 0 0 0 0 0 0 0 16 16 16 16 16 16 16 16 16 16 16 16 16 16 16 16 16 16 16 16 16 16 16 16 16 16 16 16 16 16 16 16 16 16 16 16 16 16 16 16 16 16 16 16 16 16 16 16 16 16 16 16 16 16 16 16 16 46 44 44 44 44 44 44 44 44 44 44 44 44 44 46 0 0 0 0 0 0 0 0 0 0 0 0 0 0 0 46 
46 0 0 0 0 0 0 0 0 0 0 0 16 16 16 16 16 16 16 16 16 16 16 16 16 16 16 16 16 16 16 16 16 16 16 16 16 16 16 16 16 16 16 16 16 16 16 16 16 16 16 16 16 16 16 16 16 16 16 16 16 16 16 16 16 16 16 16 16 46 44 44 44 44 44 44 44 44 44 44 44 44 44 46 0 0 0 0 0 0 0 0 0 51 46 46 46 0 0 46 
46 0 0 0 0 0 0 0 0 0 0 0 16 16 16 16 16 16 16 16 16 16 16 16 16 16 16 16 16 16 16 16 16 16 16 16 16 16 16 16 16 16 16 16 16 16 16 16 16 16 16 16 16 16 16 16 16 16 16 16 16 16 16 16 16 16 16 16 16 46 44 44 44 44 44 44 44 44 44 44 44 44 44 46 51 46 0 46 0 46 46 51 46 46 45 45 51 0 0 46 
46 0 0 0 0 0 0 0 0 0 0 0 16 16 16 16 16 16 16 16 16 16 16 16 16 16 16 16 16 16 16 16 16 16 16 16 16 16 16 16 16 16 16 16 16 16 16 16 16 16 16 16 16 16 16 16 16 16 16 16 16 16 16 16 16 16 16 16 16 51 44 44 44 44 44 44 44 44 44 44 44 44 44 44 44 46 0 46 0 46 45 45 45 45 45 45 46 47 0 51 
46 0 0 0 0 0 0 0 0 0 0 0 16 16 16 16 16 16 16 16 16 16 16 16 16 16 16 16 16 16 16 16 16 16 16 16 16 16 16 16 16 16 16 16 16 16 16 16 16 16 16 16 16 16 16 16 16 16 16 16 16 16 16 16 16 16 16 16 16 46 44 44 44 44 44 44 44 44 44 44 44 44 44 44 44 46 0 46 0 46 45 45 45 45 45 45 46 0 0 46 
51 0 0 0 0 0 0 37 0 0 0 0 46 16 16 16 16 16 16 16 16 16 16 16 16 16 16 16 16 16 16 16 16 16 16 16 16 16 16 16 16 16 16 16 16 16 16 16 16 16 16 16 16 16 16 16 16 16 16 16 16 16 16 16 16 16 16 16 16 46 44 44 44 44 44 44 44 44 44 44 44 44 44 44 44 46 0 46 0 46 45 45 45 45 45 45 51 0 0 46 
46 0 0 0 0 0 0 37 0 0 0 0 51 46 16 16 16 16 16 16 16 16 16 16 16 16 16 16 16 16 16 16 16 16 16 16 16 16 16 16 16 16 16 16 16 16 16 16 16 16 16 16 16 16 16 16 16 16 16 16 16 16 16 16 16 16 16 16 16 46 44 44 44 44 44 44 44 44 44 44 44 44 44 44 44 46 0 51 0 46 45 45 45 45 45 45 46 0 47 46 
46 0 0 0 0 0 0 37 0 0 0 0 46 46 46 16 16 16 16 16 16 16 16 16 16 16 16 16 16 16 16 16 16 16 16 16 16 16 16 16 16 16 16 16 16 16 16 16 16 16 16 16 16 16 16 16 16 16 16 16 16 16 16 16 16 16 16 16 16 48 44 44 44 44 44 44 44 44 44 44 44 44 44 44 44 46 0 46 0 46 45 45 45 45 45 45 46 0 0 46 
46 0 0 0 0 0 0 37 0 0 0 0 46 51 46 46 16 16 16 16 16 16 16 16 16 16 16 16 16 16 16 16 16 16 16 16 16 16 16 16 16 16 16 16 16 16 16 16 16 16 16 16 16 16 16 16 16 16 16 16 16 16 16 16 16 16 16 16 16 48 44 44 44 44 44 44 44 44 44 44 44 44 44 44 44 46 0 46 0 46 45 45 45 45 45 45 51 0 0 51 
46 0 0 0 0 0 0 37 0 0 0 0 49 46 46 46 51 46 46 46 51 46 46 46 51 46 51 46 46 51 46 46 46 46 46 51 46 46 46 46 46 51 46 46 46 46 46 46 51 46 46 46 46 46 46 46 51 46 46 51 46 46 47 16 16 16 16 16 16 48 51 46 46 46 45 45 45 45 45 45 45 45 45 45 45 51 0 46 0 46 45 45 45 45 45 45 46 47 0 46 
46 0 0 0 0 0 0 37 0 0 0 0 0 0 0 0 0 46 44 44 44 44 46 0 0 0 0 0 0 0 0 0 46 44 44 44 44 44 46 0 0 0 0 0 0 0 0 0 0 0 0 0 51 44 44 44 44 44 44 44 44 44 44 47 16 16 16 16 16 16 44 44 44 51 45 45 45 45 45 45 45 45 45 45 45 46 0 46 0 51 45 45 45 45 45 45 46 0 0 46 
46 0 0 0 0 0 0 37 0 0 0 0 0 0 0 0 0 0 46 51 46 46 0 0 0 0 0 0 0 0 0 0 46 44 44 44 44 44 51 0 0 0 0 0 0 0 0 0 0 0 0 0 46 46 46 46 46 46 51 49 44 44 44 44 47 16 16 16 16 44 44 44 44 46 45 45 45 45 45 45 45 45 45 45 45 46 0 46 0 46 45 45 45 45 45 45 46 0 0 46 
51 0 0 0 0 0 0 36 0 0 0 0 0 0 0 0 0 0 0 0 0 0 0 0 46 46 0 0 0 0 0 0 51 44 44 44 44 44 46 0 0 0 0 0 0 0 0 0 0 0 0 0 0 0 0 0 0 0 0 16 16 16 16 16 44 47 47 47 16 44 44 44 44 46 45 45 45 45 45 45 45 45 45 45 45 46 0 46 0 46 45 45 45 45 45 45 46 0 47 46 
46 0 0 0 31 31 31 32 46 46 46 51 46 46 0 0 0 0 0 0 0 0 0 46 45 46 0 0 0 0 0 0 46 44 44 44 44 44 46 0 0 0 0 0 0 0 0 0 0 0 0 0 0 0 0 0 0 0 0 16 16 16 16 16 44 44 44 16 16 44 44 44 44 46 51 46 46 46 46 46 46 51 46 46 46 46 0 51 0 46 46 46 46 51 46 46 51 0 0 46 
46 0 0 0 41 41 41 41 46 45 45 45 45 46 46 51 46 46 46 46 46 46 46 45 45 51 46 46 46 0 0 46 46 44 44 44 44 44 46 0 0 0 0 0 0 46 46 51 51 46 46 46 46 46 46 51 0 0 46 49 44 44 16 16 44 44 44 16 16 44 44 44 44 46 0 0 0 0 0 0 0 0 0 0 0 46 0 46 0 46 0 0 0 0 0 0 46 0 0 51 
46 50 0 0 41 41 41 41 46 45 45 45 45 45 45 45 45 45 45 45 45 45 45 45 45 46 0 0 0 0 0 46 46 46 46 46 51 46 46 0 0 0 0 0 0 46 44 44 44 44 44 44 44 44 44 46 0 0 46 44 44 44 16 16 44 44 44 16 47 44 44 44 44 46 0 0 0 0 0 0 0 0 0 0 0 46 0 46 0 46 0 0 0 0 0 0 46 47 0 46 
46 0 0 0 41 41 41 41 46 45 45 45 45 45 45 45 45 45 45 45 45 45 45 45 46 0 0 0 0 0 0 46 51 0 0 0 0 0 0 0 0 0 0 0 0 46 44 44 44 44 44 44 44 44 44 46 0 0 46 44 44 44 16 16 44 44 44 16 16 44 44 44 44 46 0 0 0 0 0 0 0 0 0 0 0 51 0 46 0 46 0 0 0 0 0 0 51 0 0 46 
46 0 0 0 41 41 41 41 46 45 45 45 45 45 45 45 45 45 45 45 45 45 45 45 46 0 0 0 51 46 46 46 0 0 0 0 0 0 0 0 0 0 0 51 46 46 44 44 44 44 44 44 44 44 44 46 0 0 46 44 44 44 16 16 44 44 44 16 16 44 44 44 44 46 0 0 0 0 0 0 0 0 0 0 0 46 0 46 0 46 0 0 0 0 0 0 46 0 0 46 
51 0 0 50 46 44 44 44 46 45 45 45 45 45 45 45 45 45 45 45 45 45 45 45 46 0 0 0 0 0 0 0 0 0 0 0 0 0 0 0 0 0 0 46 44 44 44 44 44 44 44 44 44 44 44 51 0 0 51 44 44 44 16 16 44 44 44 47 16 44 44 44 44 51 0 0 0 0 0 0 0 0 0 0 0 0 0 0 0 0 0 0 0 0 0 0 46 0 47 46 
46 0 0 0 46 44 44 44 46 45 45 45 45 45 45 45 45 45 45 45 45 45 45 45 46 51 0 0 0 0 0 0 0 0 0 51 46 0 0 46 51 0 0 46 44 44 44 44 44 44 44 44 44 44 44 46 0 0 46 44 44 44 16 16 16 16 16 16 16 48 44 44 44 46 0 0 0 0 0 0 0 0 0 0 0 0 0 0 0 0 0 0 0 0 0 0 46 0 0 46 
46 0 0 0 46 44 44 44 46 45 44 44 44 44 44 45 45 45 45 45 45 45 45 45 45 46 46 46 46 51 46 46 51 46 46 46 46 46 46 46 46 51 46 46 44 44 44 44 44 44 44 44 44 44 44 46 0 0 46 44 44 44 16 16 16 16 16 16 16 48 44 44 44 46 0 0 0 0 0 0 0 0 0 0 0 0 0 0 0 0 0 15 0 0 0 15 46 0 0 51 
46 0 0 0 51 44 44 44 44 44 44 44 44 44 44 44 44 44 44 44 44 45 45 45 45 45 45 45 45 45 45 45 45 45 45 45 44 44 44 44 44 44 44 44 44 44 44 44 44 44 44 44 44 44 44 46 0 0 46 44 44 44 48 48 46 46 46 46 46 46 44 44 44 46 0 0 0 0 0 0 0 0 0 46 49 16 16 16 49 46 51 46 46 46 46 51 46 47 0 46 
46 50 0 0 46 44 44 44 44 44 44 44 44 44 44 44 44 44 44 44 45 45 45 45 45 45 45 45 45 45 45 45 45 45 45 45 44 44 44 44 44 44 44 44 44 44 44 44 44 44 44 44 44 44 44 46 0 0 46 44 44 51 46 51 46 46 46 46 46 46 51 46 45 51 0 0 0 0 0 0 0 0 0 46 44 16 16 16 44 45 45 46 0 0 0 0 0 0 0 46 
46 0 0 0 51 44 44 44 44 44 44 44 44 44 44 44 44 44 44 44 44 44 45 45 45 45 45 45 45 45 45 45 45 45 45 45 45 44 44 44 44 44 44 44 44 44 44 44 44 44 44 44 44 44 44 51 0 0 46 46 51 46 0 0 0 0 0 0 0 0 0 46 45 46 0 0 0 0 0 0 0 51 46 46 44 16 16 16 44 45 45 46 0 0 0 0 0 0 0 46 
46 0 0 0 46 44 44 44 44 44 44 44 44 44 44 44 44 44 44 44 45 45 45 45 45 45 45 45 45 45 45 45 45 45 45 45 45 44 44 44 44 44 44 44 44 44 44 44 44 44 44 44 44 44 44 46 0 0 0 0 0 0 0 0 0 0 0 0 0 0 0 46 46 46 0 0 0 0 0 0 0 46 44 44 44 16 16 16 44 45 45 46 0 0 0 0 0 0 47 46 
51 0 0 50 46 44 44 44 44 44 44 44 44 44 44 44 44 44 44 44 44 45 45 45 45 44 44 44 45 45 44 45 45 45 45 45 45 44 44 44 44 44 44 44 44 44 44 44 44 44 44 44 44 44 44 46 0 0 0 0 0 0 0 0 0 0 0 0 0 0 0 0 0 0 0 0 0 0 0 51 46 46 44 44 44 16 16 16 45 45 45 51 0 0 0 0 0 0 0 51 
46 0 0 0 46 44 44 44 44 44 44 44 44 44 44 44 44 44 44 44 44 44 44 44 44 44 44 44 44 44 44 44 46 46 46 46 46 46 46 46 51 46 46 46 46 46 51 46 46 46 46 44 44 44 44 51 0 0 0 0 0 0 0 0 0 0 0 0 0 0 0 0 0 0 0 0 0 0 0 46 44 44 44 44 44 16 16 16 44 45 45 46 0 47 0 0 0 0 0 46 
46 0 0 0 46 44 44 44 44 44 44 44 44 44 44 44 44 44 44 44 44 44 44 44 44 44 44 44 44 44 44 44 46 0 0 0 0 0 0 0 0 0 0 0 0 0 0 0 0 0 46 44 44 44 44 46 0 0 0 0 0 0 0 0 0 0 0 0 0 0 0 51 46 46 51 46 46 51 46 46 44 44 44 44 44 16 16 16 44 45 45 46 0 0 0 0 0 0 0 46 
46 0 0 0 46 44 44 44 44 44 44 44 44 44 44 44 44 44 44 44 44 44 44 44 44 44 44 44 44 44 44 44 46 0 0 0 0 0 0 0 0 12 0 0 0 0 0 0 0 0 46 44 44 44 44 51 46 46 46 46 46 46 46 51 46 46 46 0 0 0 0 46 44 44 44 44 44 44 44 44 44 44 44 44 44 16 16 16 44 45 45 46 0 0 0 0 0 0 47 46 
46 0 0 0 46 44 44 44 44 44 44 44 44 44 44 44 44 44 44 44 44 44 44 44 44 44 44 44 44 44 44 44 46 0 15 0 13 0 15 0 47 48 47 0 15 0 11 0 15 0 46 45 45 45 45 45 45 45 45 45 45 45 45 45 45 45 51 0 0 0 0 46 46 46 51 46 46 46 51 46 46 51 46 46 49 0 0 0 49 51 46 46 0 0 0 0 0 0 0 46 
46 0 0 0 51 46 46 46 46 46 46 51 46 46 46 46 46 46 46 46 51 46 46 46 46 46 46 51 46 46 46 46 51 46 46 46 46 46 51 47 48 50 48 47 46 46 51 51 46 46 51 46 46 46 51 46 46 46 46 46 46 46 46 46 51 46 46 0 0 0 0 0 0 0 0 0 0 0 0 0 0 0 0 0 0 0 0 0 0 0 0 0 0 47 0 0 0 0 0 51 
46 0 0 0 0 0 0 0 0 0 0 0 0 0 0 0 0 0 0 0 0 0 0 0 0 0 0 0 0 0 0 0 0 0 0 0 0 0 0 0 0 0 0 0 0 0 0 0 0 0 0 0 0 0 0 0 0 0 0 0 0 0 0 0 0 0 0 0 0 0 0 0 0 0 0 0 0 0 0 0 0 0 0 0 0 0 0 0 0 0 0 0 0 0 0 0 0 0 0 46 
51 0 0 0 0 0 0 0 0 0 0 0 0 0 0 0 0 0 0 0 0 0 0 0 0 0 0 0 0 0 0 0 0 0 0 0 0 0 0 0 0 0 0 0 0 0 0 0 0 0 0 0 0 0 0 0 0 0 0 0 0 0 0 0 0 0 0 0 0 0 0 0 0 0 0 0 0 0 0 0 0 0 0 0 0 0 0 0 0 0 0 0 0 0 0 0 0 0 47 46 
46 15 0 0 15 0 0 0 0 0 0 0 0 0 0 0 0 0 0 0 0 0 0 0 0 0 0 0 0 0 0 0 0 0 0 0 0 0 0 0 0 0 0 0 0 0 0 0 0 0 0 0 0 0 0 0 0 0 0 0 0 0 0 0 0 0 0 0 0 0 0 0 0 0 0 0 0 0 0 0 0 0 0 0 0 0 0 0 0 0 0 0 0 0 0 0 0 0 0 46 
46 46 51 46 46 46 46 46 46 46 51 46 46 46 46 46 51 46 46 46 46 46 46 46 46 46 46 51 46 46 46 46 46 46 46 46 51 46 46 46 46 46 46 46 46 46 46 46 51 46 46 46 46 46 51 46 46 46 46 46 46 46 51 46 46 46 0 0 0 0 0 0 48 46 46 46 46 51 46 46 46 51 46 0 0 0 0 0 0 0 46 50 0 0 0 47 47 0 0 46 
